{
	"materials": {
		"ceiling": "stone-floor-05",
		"wall": "tiles-02",
		"floor": "sand-01"
	},
	"roomHeight": 3,
	"gridSize": 2,
	"objects": [],
	"lights": [
		{
			"position": {
				"x": 6.5625,
				"z": 4.125
			}
		},
		{
			"position": {
				"x": 10.625,
				"z": 4.0625
			}
		},
		{
			"position": {
				"x": 9.625,
				"z": 11.375
			}
		},
		{
			"position": {
				"x": 4.5,
				"z": 9.375
			}
		},
		{
			"position": {
				"x": 8.625,
				"z": 7.625
			}
		},
		{
			"position": {
				"x": 17.9375,
				"z": 7.4375
			}
		}
	],
	"monsters": [
		{
			"name": "cerberus",
			"position": {
				"x": 11,
				"z": 7
			}
		}
	],
	"start": [
		4,
		7.1875
	],
	"startAngle": 0,
	"exit": [
		16.9375,
		6.4375
	],
	"width": 40,
	"depth": 40,
	"map": [
		"                                        ",
		"                                        ",
		"                                        ",
		"   ###########                          ",
		"  ##%.......%######                     ",
		" ##%.........%##..#                     ",
		" #%...........%#..#                     ",
		" #.............#..#                     ",
		" #.............#..#                     ",
		" #%....####.......#                     ",
		" ##%.........%#####                     ",
		"  ##%.......%##                         ",
		"   #####%.%###                          ",
		"       #####                            ",
		"                                        ",
		"                                        ",
		"                                        ",
		"                                        ",
		"                                        ",
		"                                        ",
		"                                        ",
		"                                        ",
		"                                        ",
		"                                        ",
		"                                        ",
		"                                        ",
		"                                        ",
		"                                        ",
		"                                        ",
		"                                        ",
		"                                        ",
		"                                        ",
		"                                        ",
		"                                        ",
		"                                        ",
		"                                        ",
		"                                        ",
		"                                        ",
		"                                        ",
		"                                        "
	],
	"title": "Monster test"
}
